"filename", "language", "C++", "comment", "blank", "total"
"/Users/jamesweigand/Documents/msfl/src/BinUtility.cpp", "C++", 9, 0, 3, 12
"/Users/jamesweigand/Documents/msfl/src/BinUtility.h", "C++", 6, 0, 2, 8
"/Users/jamesweigand/Documents/msfl/src/ByteStream.cpp", "C++", 195, 2, 37, 234
"/Users/jamesweigand/Documents/msfl/src/ByteStream.hpp", "C++", 66, 0, 3, 69
"/Users/jamesweigand/Documents/msfl/src/Date.cpp", "C++", 133, 36, 25, 194
"/Users/jamesweigand/Documents/msfl/src/Date.hpp", "C++", 18, 0, 1, 19
"/Users/jamesweigand/Documents/msfl/src/FilePath.cpp", "C++", 42, 5, 21, 68
"/Users/jamesweigand/Documents/msfl/src/FilePath.hpp", "C++", 20, 5, 6, 31
"/Users/jamesweigand/Documents/msfl/src/FileWriter.cpp", "C++", 64, 0, 25, 89
"/Users/jamesweigand/Documents/msfl/src/FileWriter.h", "C++", 13, 0, 2, 15
"/Users/jamesweigand/Documents/msfl/src/RawBytes.cpp", "C++", 15, 1, 3, 19
"/Users/jamesweigand/Documents/msfl/src/RawBytes.hpp", "C++", 18, 1, 2, 21
"/Users/jamesweigand/Documents/msfl/src/asset.cpp", "C++", 617, 145, 190, 952
"/Users/jamesweigand/Documents/msfl/src/asset.hpp", "C++", 96, 14, 8, 118
"/Users/jamesweigand/Documents/msfl/src/balloon.cpp", "C++", 1371, 371, 455, 2197
"/Users/jamesweigand/Documents/msfl/src/balloon.hpp", "C++", 123, 42, 18, 183
"/Users/jamesweigand/Documents/msfl/src/bitmap.cpp", "C++", 40, 2, 15, 57
"/Users/jamesweigand/Documents/msfl/src/bitmap.hpp", "C++", 25, 0, 3, 28
"/Users/jamesweigand/Documents/msfl/src/bitmapRender.cpp", "C++", 52, 3, 13, 68
"/Users/jamesweigand/Documents/msfl/src/bitmapRender.hpp", "C++", 15, 9, 2, 26
"/Users/jamesweigand/Documents/msfl/src/cfgParse.cpp", "C++", 342, 67, 124, 533
"/Users/jamesweigand/Documents/msfl/src/cfgParse.hpp", "C++", 58, 13, 9, 80
"/Users/jamesweigand/Documents/msfl/src/jparse.cpp", "C++", 465, 75, 85, 625
"/Users/jamesweigand/Documents/msfl/src/jparse.hpp", "C++", 62, 6, 14, 82
"/Users/jamesweigand/Documents/msfl/src/main.cpp", "C++", 108, 45, 32, 185
"/Users/jamesweigand/Documents/msfl/src/mcrpyt.hpp", "C++", 0, 0, 1, 1
"/Users/jamesweigand/Documents/msfl/src/msfl.hpp", "C++", 8, 32, 4, 44
"/Users/jamesweigand/Documents/msfl/src/msutil.hpp", "C++", 104, 0, 21, 125
"/Users/jamesweigand/Documents/msfl/src/pak.cpp", "C++", 548, 154, 199, 901
"/Users/jamesweigand/Documents/msfl/src/pak.hpp", "C++", 58, 10, 15, 83
"/Users/jamesweigand/Documents/msfl/src/png.cpp", "C++", 57, 6, 20, 83
"/Users/jamesweigand/Documents/msfl/src/png.hpp", "C++", 20, 0, 2, 22
"/Users/jamesweigand/Documents/msfl/src/ptrconverter.hpp", "C++", 11, 0, 3, 14
"/Users/jamesweigand/Documents/msfl/src/ttf.cpp", "C++", 309, 86, 98, 493
"/Users/jamesweigand/Documents/msfl/src/ttf.hpp", "C++", 94, 10, 11, 115
"/Users/jamesweigand/Documents/msfl/src/ttfRender.cpp", "C++", 233, 66, 69, 368
"/Users/jamesweigand/Documents/msfl/src/ttfRender.hpp", "C++", 7, 0, 1, 8
"/Users/jamesweigand/Documents/msfl/src/ttfgl.cpp", "C++", 0, 0, 1, 1
"/Users/jamesweigand/Documents/msfl/src/ttfgl.hpp", "C++", 0, 0, 1, 1
"/Users/jamesweigand/Documents/msfl/src/wav.hpp", "C++", 3, 0, 2, 5
"/Users/jamesweigand/Documents/msfl/src/xml.cpp", "C++", 584, 69, 134, 787
"/Users/jamesweigand/Documents/msfl/src/xml.hpp", "C++", 85, 8, 15, 108
"/Users/jamesweigand/Documents/msfl/src/yaml.cpp", "C++", 0, 0, 1, 1
"/Users/jamesweigand/Documents/msfl/src/yaml.hpp", "C++", 1, 0, 1, 2
"/Users/jamesweigand/Documents/msfl/src/zip.cpp", "C++", 0, 0, 1, 1
"/Users/jamesweigand/Documents/msfl/src/zip.h", "C++", 1, 9, 0, 10
"Total", "-", 6096, 1292, 1698, 9086