"filename", "language", "C++", "JSON", "comment", "blank", "total"
"/Users/jamesweigand/Documents/msfl/src/BinUtility.cpp", "C++", 9, 0, 0, 3, 12
"/Users/jamesweigand/Documents/msfl/src/BinUtility.h", "C++", 6, 0, 0, 2, 8
"/Users/jamesweigand/Documents/msfl/src/ByteStream.cpp", "C++", 195, 0, 2, 37, 234
"/Users/jamesweigand/Documents/msfl/src/ByteStream.hpp", "C++", 66, 0, 0, 3, 69
"/Users/jamesweigand/Documents/msfl/src/FileWriter.cpp", "C++", 64, 0, 0, 25, 89
"/Users/jamesweigand/Documents/msfl/src/FileWriter.h", "C++", 13, 0, 0, 2, 15
"/Users/jamesweigand/Documents/msfl/src/RawBytes.cpp", "C++", 15, 0, 1, 3, 19
"/Users/jamesweigand/Documents/msfl/src/RawBytes.hpp", "C++", 18, 0, 1, 2, 21
"/Users/jamesweigand/Documents/msfl/src/asset.cpp", "C++", 445, 0, 105, 150, 700
"/Users/jamesweigand/Documents/msfl/src/asset.hpp", "C++", 81, 0, 16, 7, 104
"/Users/jamesweigand/Documents/msfl/src/balloon.cpp", "C++", 1371, 0, 371, 455, 2197
"/Users/jamesweigand/Documents/msfl/src/balloon.hpp", "C++", 123, 0, 42, 18, 183
"/Users/jamesweigand/Documents/msfl/src/bitmap.cpp", "C++", 40, 0, 2, 15, 57
"/Users/jamesweigand/Documents/msfl/src/bitmap.hpp", "C++", 25, 0, 0, 3, 28
"/Users/jamesweigand/Documents/msfl/src/bitmapRender.cpp", "C++", 52, 0, 3, 13, 68
"/Users/jamesweigand/Documents/msfl/src/bitmapRender.hpp", "C++", 15, 0, 9, 2, 26
"/Users/jamesweigand/Documents/msfl/src/cfgParse.cpp", "C++", 342, 0, 67, 124, 533
"/Users/jamesweigand/Documents/msfl/src/cfgParse.hpp", "C++", 58, 0, 13, 9, 80
"/Users/jamesweigand/Documents/msfl/src/jparse.cpp", "C++", 465, 0, 75, 85, 625
"/Users/jamesweigand/Documents/msfl/src/jparse.hpp", "C++", 59, 0, 6, 13, 78
"/Users/jamesweigand/Documents/msfl/src/main.cpp", "C++", 107, 0, 39, 27, 173
"/Users/jamesweigand/Documents/msfl/src/mcrpyt.hpp", "C++", 0, 0, 0, 1, 1
"/Users/jamesweigand/Documents/msfl/src/msfl.hpp", "C++", 8, 0, 32, 4, 44
"/Users/jamesweigand/Documents/msfl/src/msutil.hpp", "C++", 48, 0, 0, 10, 58
"/Users/jamesweigand/Documents/msfl/src/pak.cpp", "C++", 548, 0, 154, 199, 901
"/Users/jamesweigand/Documents/msfl/src/pak.hpp", "C++", 58, 0, 10, 15, 83
"/Users/jamesweigand/Documents/msfl/src/png.cpp", "C++", 57, 0, 6, 20, 83
"/Users/jamesweigand/Documents/msfl/src/png.hpp", "C++", 20, 0, 0, 2, 22
"/Users/jamesweigand/Documents/msfl/src/ptrconverter.hpp", "C++", 11, 0, 0, 3, 14
"/Users/jamesweigand/Documents/msfl/src/test.json", "JSON", 0, 38227, 0, 1, 38228
"/Users/jamesweigand/Documents/msfl/src/ttf.cpp", "C++", 309, 0, 86, 98, 493
"/Users/jamesweigand/Documents/msfl/src/ttf.hpp", "C++", 94, 0, 10, 11, 115
"/Users/jamesweigand/Documents/msfl/src/ttfRender.cpp", "C++", 233, 0, 66, 69, 368
"/Users/jamesweigand/Documents/msfl/src/ttfRender.hpp", "C++", 7, 0, 0, 1, 8
"/Users/jamesweigand/Documents/msfl/src/wav.hpp", "C++", 3, 0, 0, 2, 5
"/Users/jamesweigand/Documents/msfl/src/xml.cpp", "C++", 584, 0, 69, 134, 787
"/Users/jamesweigand/Documents/msfl/src/xml.hpp", "C++", 85, 0, 8, 15, 108
"/Users/jamesweigand/Documents/msfl/src/yaml.cpp", "C++", 0, 0, 0, 1, 1
"/Users/jamesweigand/Documents/msfl/src/yaml.hpp", "C++", 1, 0, 0, 1, 2
"/Users/jamesweigand/Documents/msfl/src/zip.cpp", "C++", 0, 0, 0, 1, 1
"/Users/jamesweigand/Documents/msfl/src/zip.h", "C++", 1, 0, 9, 0, 10
"Total", "-", 5636, 38227, 1202, 1586, 46651